{
  "interiorTiles": [
    "0 0 0 0 0 0 0 0 0 0 0 0 0 0 0 0 0 0",
    "0 0 0 0 0 0 0 0 0 0 0 0 0 0 0 0 0 0",
    "0 0 0 0 0 0 0 0 0 0 0 0 0 0 0 0 0 0",
    "0 0 0 0 0 0 0 0 0 0 0 0 0 0 0 0 0 0",
    "0 0 0 0 0 0 0 0 0 0 0 0 0 0 0 0 0 0",
    "0 0 0 2 2 2 2 2 0 0 0 0 0 0 0 0 0 0",
    "0 0 0 2 4 4 4 2 0 0 0 0 0 0 0 0 0 0",
    "0 0 0 2 4 4 4 2 0 0 0 0 0 0 0 0 0 0",
    "0 0 0 2 4 4 4 2 0 0 0 0 0 0 0 0 0 0",
    "0 0 0 2 2 3 2 2 0 0 0 0 0 0 0 0 0 0",
    "0 0 0 0 0 0 0 0 0 0 0 0 0 0 0 0 0 0",
    "0 0 0 0 0 0 0 0 0 0 0 0 0 0 0 0 0 0",
    "0 0 0 0 0 0 0 0 0 0 0 0 0 0 0 0 0 0",
    "0 0 0 0 0 0 0 0 0 0 0 0 0 0 0 0 0 0",
    "0 0 0 0 0 0 0 0 0 0 0 0 0 0 0 0 0 0"
  ],
  "tiles": [
    "2 2 2 2 2 2 2 2 2 2 2 2 2 2 2 2 2 2",
    "2 0 0 0 0 0 0 0 0 0 0 0 0 0 0 0 0 2",
    "2 0 0 0 0 0 0 0 0 0 0 0 0 0 0 0 0 2",
    "2 0 0 0 0 0 0 0 0 0 0 2 2 2 2 0 0 2",
    "2 0 0 0 0 0 0 0 0 0 0 2 2 2 2 0 0 2",
    "2 0 0 2 2 2 2 2 0 0 0 2 2 2 2 0 0 2",
    "2 0 0 2 2 2 2 2 0 0 0 0 0 0 0 0 0 2",
    "2 0 0 2 2 2 2 2 0 0 0 0 0 0 0 0 0 2",
    "2 0 0 2 2 2 2 2 0 0 0 0 0 0 0 0 0 2",
    "2 0 0 2 2 3 2 2 0 0 0 0 0 0 0 0 0 2",
    "2 0 0 0 0 0 0 0 0 0 0 0 1 1 1 0 0 2",
    "2 0 0 0 0 0 0 0 0 0 0 0 1 1 1 0 0 2",
    "2 0 0 0 0 0 0 0 0 0 0 0 1 1 1 0 0 2",
    "2 0 0 0 0 0 0 0 0 0 0 0 0 0 0 0 0 2",
    "2 2 2 2 2 2 2 2 2 2 2 2 2 2 2 2 2 2"
  ],
  "player": {
    "position": [6, 12]
  },
  "enemies": [{
    "type": "Spike",
    "position": [700, 200]
  }, {
    "type": "Shooty",
    "position": [1600, 700]
  }],
  "powerUps": [{
    "type": "sword_powerup",
    "position": [500, 350]
  }, {
    "type": "spear_powerup",
    "position": [700, 450]
  }, {
    "type": "hammer_powerup",
    "position": [850, 400]
  }]
}